WXXXXXXXXXXXXXXXXXXXXXXXXXXXOOOOOOW
WOOOOOOOOOOOOOOOOOOOOOOOOOOOOOOOOOW
WOOOOOOOOOOOOOOOOOOOOOOOOOOOOOOOOOW
WOOOOOOOOOOOOOOOOOOOOOOOOOOOOOOOOOW
WOOOOOOOOOOOOOOOOOOOOOOOOOOOOOOOOOW
WOOOOOOOOOOOOOOOOOOOOOOOOOOOOOOOOOW
WOOOOOOOOOOOOOOOOOOOOOOOOOOOXXXXXXW
WOOOOOOOOOOOOOOOOOOOOOOOOOOOXXXXXXW
WOOOOOOOOOOOOOOOOOOOOOOOOOOOOOOOOOW
WOOOOOOOOOOOOOOOOOOOHOOOOOOOOOOOOOW
WOOOOOOOOOOOOOOOOOOOOOOOOOOOOOOOOOW
WOOOOOOOOOOOOOOOOOOOOOOOOOOOOOOOOOW
WOOOOOOOOOOOHOOOOOOOOOOOOOOOOOOOOOW
WOOOOOOOOOOOOOOOOOOOOOOOOOOOOOOOOOW
WOOOOOOOOOOOOOOOOOOOOOOOOOOOOOOOOOW
WOOOOOOOOOOOOOOOOOOOOOOOOOOOOOOOOOW
WOOOOOOOOOOOOOOOOOOOOOOOOOOOOOOOOOW
WOOOOOOOOOOOOOOOOOOOOOOOOOOOOOOOOOW
WOOOOOEOOOOOOOOOOOOOOOOOOOOOOOOOOOW
WOXXXXXXXXXOOOOOOOOOOOOOOOOOOOOOOOW
WOXXXXXXXXXOOOOOOOOOOOOOOOOOOOOOOOW
WOOOOOOOOOOOOOOOOOOOOOOOOOOOOOOOOOW
WOOOOOOOOOOOOOOOOOOOOOOOOOOOOOOOOOW
WOOOOOOOOOOOOOOOOOOOOOOOOOOOOOOOOOW
WOOOOOOOOOOOOOOOOOOOOOOOOOOOOOOOOOW
WOOOOOOOOOOOOOOOOOOOOOOOOOOOOOOOOOW
WOOOOOOOOOOOOOOOOOOOOOOOOOOOOOOOOOW
WOOOOOOOOOOOOOOOOOOOOOOOOOOOOOOOOOW
WOOOOOOOOOOOOOOOOOOOOOOOOOOOOOOOOOW
WOOOOOOOOOOOHOOOOOOOOOOOOOOOOOOOOOW
WOOOOOOOOOOOOOOOOOOOOOOOOOOOOOOOOOW
WOOOOOOOOOOOOOOOOOOOOOOOOOOOOOOOOOW
WOOOOOOOOOOOOOOOOOOOOOOOOOOOOOOOOOW
WOOOOOOOOOOOOOOOOOOOOOOOOOOOOOOOOOW
WOOOOOOOOOOOOOOOOOOOOOOOOOOOOOOOOOW
WOOOOOOOOOOOOOOOOOOOOOOOOOOOOOOOOOW
WOOOOOOOOOOOOOOOOOOOOOOOOOOOOOOOOOW
WOOOOOOOOOOOOOOOOOOOOOOOOOOOOOOOOOW
WOOOOOOOOOOOOOOHOOOOOOOOOOOOOOOOOOW
WOOOOOOOOOOOOOOOOOOOOOOOOOOOOOOOOOW
WOOOOOOOOOOOOOOOOOOOOOOOOOOOOOOOOOW
WOOOOOOOOOOOOOOOOOOOOOOOOOOOOOOOOOW
WOOOOOOOOOOOOOOOOOOOOOOOOOOOOOOOOOW
WXXXXXXXXXXXXXXXXXXXXXXXOOOOOOOOOOW
WXXXXXXXXXXXXXXXXXXXXXXXOOOOOOOOOOW